Honey	The Mechanic
Ice Age: Dawn of the Dinosaurs	A Very Harold & Kumar 3D Christmas
The Hurt Locker	The Conjuring
Old School	Lone Survivor
Speed	Resident Evil: Apocalypse
Harold & Kumar Go to White Castle	The Hobbit: An Unexpected Journey
Suicide Squad	Rush
Toy Story	Sex and the City
Deadpool	The Dead Pool
Finding Dory	Finding Nemo
Se7en	The Bourne Legacy
Cube	Man on Fire
The Deer Hunter	Muppets Most Wanted
Taken	Taken 2
Elf	Bad Lieutenant
Bridesmaids	The Mechanic
The Truman Show	The Breakfast Club
The Godfather: Part II	Cheaper by the Dozen
Inside Man	The Good, the Bad and the Ugly
The Tree of Life	Heathers
Alone in the Dark	The Artist
Night at the Museum	Beneath the Planet of the Apes
Tinker Bell and the Lost Treasure	The Jewel of the Nile
V for Vendetta	The Lord of the Rings: The Two Towers
The Mummy Returns	Bruno
Natural Born Killers	Madagascar: Escape 2 Africa
Pirates of the Caribbean: On Stranger Tides	Jason Lives: Friday the 13th Part VI
Madagascar	X2
Child's Play 3	The Fast and the Furious: Tokyo Drift
Friday the 13th: The Final Chapter	Friday the 13th Part VII: The New Blood
Piranha 3DD	Piranha 3D
Scary Movie 2	The Conjuring 2
Manchester by the Sea	The Talented Mr. Ripley
The Hunger Games	The Wolf of Wall Street
Teenage Mutant Ninja Turtles	From Dusk Till Dawn
Scent of a Woman	Child's Play 2
Exorcist: The Beginning	Adventureland
12 Years a Slave	The Shining
The Martian	Little Miss Sunshine
Stranger Than Fiction	The 40-Year-Old Virgin
The Hills Have Eyes II	X-Men: Apocalypse
World War Z	American Sniper
Lord of War	O Brother, Where Art Thou?
Behind Enemy Lines	Toy Story 2
Prisoners	A Cinderella Story
Superman II	Insidious: Chapter 2
Saw II	Bad Lieutenant
The Shawshank Redemption	Scary Movie
Hacksaw Ridge	Independence Day
Goldfinger	Casino Royale
Life of Pi	Mission: Impossible III
25th Hour	The Wolf of Wall Street
Superman	Batman v Superman
Shrek	Shrek the Third
Muppets Most Wanted	The Muppets Take Manhattan
Wrath of the Titans	Universal Soldier: The Return
Boogie Nights	Dead Poets Society
Moneyball	World War Z
First Blood	Ace Ventura: When Nature Calls
Casablanca	Rocky IV
The Cabin in the Woods	Shutter Island
Catch Me If You Can	Jumanji
Spy Kids 3: Game Over	Spy Kids: All the Time in the World in 4D
King Kong	Ocean's Twelve
Paranormal Activity 2	The Bourne Legacy
Das Boot	Pirates of the Caribbean: At World's End
Miss Congeniality 2: Armed and Fabulous	Step Up 2: The Streets
The Town	Into the Blue
Mean Girls	Poltergeist II: The Other Side
Inside Out	Tucker and Dale vs Evil
Jackie Brown	The Three Musketeers
Road to Perdition	Rocky IV
The Matrix Reloaded	The Matrix Revolutions
Scream	Life of Pi
Aladdin	Monsters
The Darjeeling Limited	The Mechanic
Charlie's Angels: Full Throttle	Alone in the Dark
Rocky III	Lost in Translation
Spider-Man 2	The Amazing Spider-Man 2
The Place Beyond the Pines	Superman IV: The Quest for Peace
Shrek the Third	Shrek
A Cinderella Story	Prisoners
Universal Soldier	Universal Soldier: Day of Reckoning
Rocky	On the Waterfront
The Woman in Black 2: Angel of Death	WALLÃ‚Â·E
The Girl Who Played with Fire	Mirrors
The Ring Two	The Ring
Ace Ventura: When Nature Calls	21 Grams
The Lion King	Resident Evil: Apocalypse
Dog Day Afternoon	The Breakfast Club
Alice Through the Looking Glass	The Hills Have Eyes
Battle for the Planet of the Apes	Man on the Moon
Mad Max Beyond Thunderdome	The Hangover Part II
Kick-Ass 2	Monsters
American Sniper	World War Z
The Arrival	Arrival
The Hunger Games: Catching Fire	Ratatouille
Mirrors	The Godfather: Part III
Little Miss Sunshine	The Grand Budapest Hotel
Police Story: Lockdown	The Artist
Heat	Arrival
Mad Max	The Grudge 2
The Descent: Part 2	2 Fast 2 Furious
American Beauty	Apocalypto
Toy Story 2	Behind Enemy Lines
Traffic	The Deer Hunter
Spotlight	From Dusk Till Dawn
Sherlock Holmes	The Exorcist III
Mission: Impossible II	Mission: Impossible - Ghost Protocol
Sniper: Reloaded	I Know What You Did Last Summer
A History of Violence	Bad Boys II
Star Trek: First Contact	Star Trek
Shutter Island	Friday the 13th Part VII: The New Blood
Wall Street: Money Never Sleeps	Hulk
Harry Potter and the Half-Blood Prince	Little Miss Sunshine
Bad Boys	Exorcist: The Beginning
Avatar	Shrek
Dumb and Dumber	The Texas Chainsaw Massacre 2
The Lost World: Jurassic Park	An American Werewolf in London
Jumanji	Catch Me If You Can
Alien	Aliens
Braveheart	Atlas Shrugged: Part I
The Descent	The Terminator
Despicable Me 2	The Dead Pool
Almost Famous	O Brother, Where Art Thou?
Batman Returns	Amores Perros
The Final Conflict	Beneath the Planet of the Apes
Interview with the Vampire: The Vampire Chronicles	The Ring
Boogeyman	Kick-Ass
Room	Police Academy 3: Back in Training
Fantastic Mr. Fox	The Grand Budapest Hotel
Underworld Awakening	Underworld: Evolution
Doctor Dolittle	Doctor Strange
Forrest Gump	Independence Day
Fear and Loathing in Las Vegas	Clash of the Titans
Starship Troopers 3: Marauder	The Ring
Gangs of New York	Carrie
To Kill a Mockingbird	Harry Potter and the Deathly Hallows: Part 1
Underworld	Underworld: Evolution
X-Men: Apocalypse	Transformers: Revenge of the Fallen
Planet of the Apes	Rise of the Planet of the Apes
Scary Movie	Scott Pilgrim vs. the World
Casino Royale	Goldfinger
Cars	The Adventures of Tintin
Sing	Lawrence of Arabia
Dirty Dancing	Star Wars: Episode III - Revenge of the Sith
A Bugs Life	Galaxy Quest
Ice Age: Continental Drift	Psycho
Harry Potter and the Goblet of Fire	Friday the 13th: The Final Chapter
Balto	RED
G.I. Joe: Retaliation	Harry Potter and the Chamber of Secrets
Nightcrawler	Cheaper by the Dozen
The Goonies	Magnolia
This Is the End	Animal House
Misery	Friday the 13th: A New Beginning
Independence Day	The Terminator
Child's Play	A Very Harold & Kumar 3D Christmas
Alice in Wonderland	Alice Through the Looking Glass
Star Trek V: The Final Frontier	Universal Soldier: The Return
Kung Fu Panda	Juno
Amores Perros	The Karate Kid Part III
Big Fish	The Godfather: Part III
Spy Kids: All the Time in the World in 4D	Spy Kids 3: Game Over
Hellboy	Cape Fear
Atlas Shrugged: Part I	The Silence of the Lambs
Clash of the Titans	Beneath the Planet of the Apes
Shaun of the Dead	World War Z
The Hills Have Eyes	Psycho
Dances with Wolves	Freddy's Dead: The Final Nightmare
Black Swan	Brazil
American History X	Sherlock Holmes: A Game of Shadows
The Omen	A Very Harold & Kumar 3D Christmas
The Enforcer	The Nice Guys
Tinker Tailor Soldier Spy	Exorcist II: The Heretic
The Lego Movie	Little Miss Sunshine
Gran Torino	Hannibal Rising
Doctor Strange	Doctor Dolittle
The Expendables	Awakenings
Miss Congeniality	X2
The Usual Suspects	Brokeback Mountain
The Mummy: Tomb of the Dragon Emperor	Sex and the City
Gattaca	Friday the 13th: The Final Chapter
The World Is Not Enough	Diamonds Are Forever
The Incredibles	Deadpool
Police Academy 6: City Under Siege	Being John Malkovich
X-Men	The Karate Kid Part III
Requiem for a Dream	Speed
Bridget Jones: The Edge of Reason	The Karate Kid Part III
Iron Man Three	Iron Man
Once Upon a Time in America	Poltergeist III
Bad Lieutenant	Beneath the Planet of the Apes
Men in Black 3	Police Academy 6: City Under Siege
Quarantine 2: Terminal	The Texas Chainsaw Massacre 2
The Blues Brothers	The Lord of the Rings: The Two Towers
Reservoir Dogs	Happy Feet
The Fast and the Furious: Tokyo Drift	Child's Play 3
The Blind Side	The Fighter
Zero Dark Thirty	The Hunger Games
Zodiac	Magnolia
The Hobbit: The Desolation of Smaug	Police Story 2
The Hangover Part II	Zoolander
The Dead Pool	Deadpool
Harry Potter and the Deathly Hallows: Part 1	To Kill a Mockingbird
Elizabeth	Poltergeist II: The Other Side
Johnny English Reborn	City of God
Insidious: Chapter 3	Catch Me If You Can
Snatch	The Collection
RoboCop	Unbreakable
X-Men: The Last Stand	American Psycho
Napoleon Dynamite	Lord of War
District 9	The Final Destination
Freddy's Dead: The Final Nightmare	Cape Fear
Final Destination 3	The Final Destination
Sleepy Hollow	Apollo 13
The Hangover	Shrek 2
Garden State	Changeling
Titanic	Point Break
Rush Hour	Logan
Aliens	Alien
Silver Linings Playbook	Snatch
The Simpsons Movie	X2
Pirates of the Caribbean: Dead Man's Chest	Universal Soldier: Day of Reckoning
Training Day	Carrie
Star Trek II: The Wrath of Khan	The Mechanic
Jason Goes to Hell: The Final Friday	Babel
The Jewel of the Nile	Tinker Bell and the Lost Treasure
Pirates of the Caribbean: At World's End	Das Boot
Spider-Man 3	Bad Santa
Shrek 2	The Hangover
The Three Musketeers	The Last Exorcism
The Exorcist III	Galaxy Quest
Gone Baby Gone	Boyz n the Hood
Captain America: The First Avenger	Magnolia
The Hangover Part III	Hellboy
Blade	Madagascar
Lilo & Stitch	The Talented Mr. Ripley
True Grit	Psycho
Olympus Has Fallen	The Transporter
Clerks	Clerks II
Wall Street	The Wolf of Wall Street
Mission: Impossible	Mission: Impossible - Ghost Protocol
Snowpiercer	The Insider
The Prince and Me	Mirrors
Madagascar 3: Europe's Most Wanted	Police Academy 3: Back in Training
The Vow	The Simpsons Movie
Mulan	Minions
The Muppets Take Manhattan	Muppets Most Wanted
G.I. Joe: The Rise of Cobra	Se7en
Bambi	The Karate Kid Part III
Toy Story 3	Juno
Princess Mononoke	Brazil
Universal Soldier: Day of Reckoning	Universal Soldier: The Return
The Bourne Ultimatum	Spirited Away
The Abyss	Transformers: Revenge of the Fallen
Saw III	Resident Evil: Degeneration
Tucker and Dale vs Evil	Thank You for Smoking
The Transporter	The Lord of the Rings: The Two Towers
Wrong Turn 4: Bloody Beginnings	Friday the 13th Part VII: The New Blood
X-Men: Days of Future Past	X: First Class
S.W.A.T.	The Descent: Part 2
Saving Private Ryan	The Silence of the Lambs
The X Files	Gran Torino
The Terminator	American Sniper
The Amazing Spider-Man 2	Spider-Man 2
Men in Black	Dog Day Afternoon
Being John Malkovich	Police Academy 6: City Under Siege
Jason Lives: Friday the 13th Part VI	Sicario
Resident Evil: Retribution	Resident Evil: Apocalypse
Gone with the Wind	Poltergeist II: The Other Side
Poltergeist	Poltergeist III
My Big Fat Greek Wedding	28 Weeks Later
The Aviator	Clash of the Titans
The Adventures of Tintin	Cars
Inglourious Basterds	Magnolia
Minority Report	Cheaper by the Dozen 2
The Wizard of Oz	The Fast and the Furious
Universal Soldier: The Return	Universal Soldier: Day of Reckoning
Saw IV	Being John Malkovich
RED	Cheaper by the Dozen 2
The Conjuring 2	Scary Movie 2
Fright Night	Quantum of Solace
Monsters	The Good, the Bad and the Ugly
Michael Clayton	Awakenings
The Karate Kid Part II	Hannibal Rising
Home Alone	Finding Nemo
Happy Feet	Bad Lieutenant
Star Wars: Episode II - Attack of the Clones	Scary Movie 4
Ocean's Twelve	Sicario
Basic Instinct	Friday the 13th: A New Beginning
Insidious: Chapter 2	Magnolia
The Bourne Identity	Cast Away
Bridget Jones's Diary	Bad Boys II
Fight Club	The Grudge
Love Actually	The Talented Mr. Ripley
Star Wars: Episode III - Revenge of the Sith	Galaxy Quest
Into the Blue	The Town
Harry Potter and the Chamber of Secrets	Galaxy Quest
Moonrise Kingdom	Mulan
The Ring	The Ring Two
Burn After Reading	Star Wars: Episode IV - A New Hope
Grease	Star Trek IV: The Voyage Home
Fantastic Four: Rise of the Silver Surfer	Changeling
Army of Darkness	Evil Dead II
A Fistful of Dollars	Psycho II
Easy Rider	Noah
Ghostbusters II	The Virgin Suicides
Beneath the Planet of the Apes	Clash of the Titans
Romancing the Stone	Into the Blue
The Prestige	Cheaper by the Dozen
Psycho II	Psycho
Addams Family Values	Pirates of the Caribbean: On Stranger Tides
28 Weeks Later	My Big Fat Greek Wedding
Gladiator	Zoolander
Batman	Lone Survivor
Star Wars: Episode IV - A New Hope	Star Wars: Episode VII - The Force Awakens
The Pink Panther	Spy Kids 3: Game Over
The Prophecy	Moon
The Last Exorcism	Mud
Pink Flamingos	The Transporter
Gone Girl	Mulan
An American Werewolf in London	The Lost World: Jurassic Park
Dirty Harry	Adventureland
Taken 3	Taken 2
Sling Blade	The Final Destination
Raiders of the Lost Ark	Indiana Jones and the Last Crusade
Empire of the Sun	Cape Fear
Gremlins	The Dead Pool
The X Files: I Want to Believe	The Bourne Legacy
The Hobbit: An Unexpected Journey	The Hangover Part II
From Dusk Till Dawn	Ghost Rider
The Last King of Scotland	Star Wars: Episode III - Revenge of the Sith
Animal House	This Is the End
Poltergeist III	Once Upon a Time in America
The Big Lebowski	The Good, the Bad and the Ugly
The Hateful Eight	BloodRayne
The Breakfast Club	Dog Day Afternoon
Escape from the Planet of the Apes	Rise of the Planet of the Apes
A Very Harold & Kumar 3D Christmas	Child's Play
Atonement	Superman IV: The Quest for Peace
Kiss Kiss Bang Bang	Superman IV: The Quest for Peace
Kill Bill: Vol. 1	Starship Troopers
Planet Terror	Police Academy 6: City Under Siege
Exorcist II: The Heretic	A Fistful of Dollars
Iron Man 2	Iron Man Three
Final Destination	The Final Conflict
Machete	The Dark Knight Rises
Divergent	Mulan
Cast Away	The Good, the Bad and the Ugly
A Few Good Men	22 Jump Street
Magic Mike	The Wolf of Wall Street
O Brother, Where Art Thou?	Lord of War
The Lord of the Rings: The Two Towers	The Transporter
Blade II	Blade: Trinity
X-Men Origins: Wolverine	Spider-Man 3
Sherlock Holmes: A Game of Shadows	Being John Malkovich
Madagascar: Escape 2 Africa	Transformers: Revenge of the Fallen
Zootopia	Thank You for Smoking
New Nightmare	The Wedding Singer
Resident Evil: Apocalypse	Resident Evil: Retribution
The Evil Dead	National Treasure
The Dark Knight	Spider-Man 2
Thank You for Smoking	Tucker and Dale vs Evil
50/50	Scary Movie
WALLÃ‚Â·E	Galaxy Quest
Iron Man	Iron Man Three
Star Trek Into Darkness	Spotlight
Terminator 2: Judgment Day	Transformers: Revenge of the Fallen
Up in the Air	Step Up 2: The Streets
The Talented Mr. Ripley	Lilo & Stitch
101 Dalmatians	Poltergeist III
Les MisÃƒÂ©rables	Leatherface: Texas Chainsaw Massacre III
The Fugitive	Teenage Mutant Ninja Turtles
Anchorman: The Legend of Ron Burgundy	Marley & Me
Man on Fire	Harry Potter and the Deathly Hallows: Part 1
The Twilight Saga: New Moon	A Fistful of Dollars
Harry Potter and the Order of the Phoenix	X-Men: Days of Future Past
The Texas Chainsaw Massacre 2	Quarantine 2: Terminal
Scarface	Mirrors
The Wolf of Wall Street	Wall Street
Three Kings	Shrek
The Butterfly Effect 2	The Butterfly Effect 3: Revelations
Step Up	Into the Blue
Children of Men	Police Academy 3: Back in Training
The 40-Year-Old Virgin	Lawrence of Arabia
Prometheus	From Dusk Till Dawn
The Fast and the Furious	The Wizard of Oz
Cape Fear	Empire of the Sun
Brokeback Mountain	Beneath the Planet of the Apes
Cheaper by the Dozen 2	Rocky III
Back to the Future Part II	Friday the 13th Part VII: The New Blood
Indiana Jones and the Kingdom of the Crystal Skull	Gattaca
Cheaper by the Dozen	The Godfather: Part II
Escape from New York	The Transporter
Transformers: Revenge of the Fallen	Alvin and the Chipmunks: The Squeakquel
Big Hero Six	The Bourne Identity
Live Free or Die Hard	Police Academy 6: City Under Siege
Finding Nemo	Finding Dory
Harry Potter and the Sorcerer's Stone	Harry Potter and the Order of the Phoenix
Insurgent	Hannibal Rising
Minions	Iron Man
Happy Gilmore	I Know What You Did Last Summer
Starship Troopers	Natural Born Killers
North by Northwest	Poltergeist III
21 Grams	Piranha 3D
Fortress	A Fistful of Dollars
Magnolia	Leatherface: Texas Chainsaw Massacre III
Underworld: Evolution	Underworld: Rise of the Lycans
Donnie Darko	BloodRayne
Blade: Trinity	Blade II
Mission: Impossible III	Life of Pi
AmÃƒÂ©lie	Final Destination 2
The Fifth Element	Moon
Sin City	Basic Instinct
Final Destination 5	Mission: Impossible III
Red Dragon	Dog Day Afternoon
Friday the 13th Part VII: The New Blood	Friday the 13th: The Final Chapter
Apollo 13	Sleepy Hollow
Paranormal Activity	Sniper: Reloaded
Terms of Endearment	Police Academy 3: Back in Training
Indiana Jones and the Last Crusade	Raiders of the Lost Ark
Frozen	Minions
22 Jump Street	Dead Poets Society
Friday the 13th: A New Beginning	Basic Instinct
Juno	Apocalypto
National Treasure	The Evil Dead
Tootsie	Freddy's Dead: The Final Nightmare
Transformers	Transformers: Revenge of the Fallen
The Mechanic	Star Trek II: The Wrath of Khan
The Lives of Others	The Others
Scream 2	Election
Lethal Weapon 2	The Wedding Singer
Heathers	The Tree of Life
Splice	BloodRayne
The Bourne Legacy	The Lost Boys
Dr. No	Goldfinger
Zoolander	The Hangover Part II
Battle Royale	Finding Nemo
Get Out	2 Fast 2 Furious
Big	Natural Born Killers
Zombieland	The Terminator
Harry Potter and the Prisoner of Azkaban	Johnny English Reborn
Stand by Me	The Town
Nocturnal Animals	Mirrors
Captain Phillips	Drag Me to Hell
X: First Class	X-Men: Days of Future Past
The Wedding Singer	Bad Santa
The Orphanage	Edward Scissorhands
Eyes Wide Shut	Sicario
Slumdog Millionaire	True Grit
Police Story 4: First Strike	From Dusk Till Dawn
In the Line of Fire	Beneath the Planet of the Apes
Scary Movie 4	Se7en
True Romance	Iron Man
The Fly	Halloween
The Four Musketeers: Milady's Revenge	The Woman in Black
The Butterfly Effect 3: Revelations	The Butterfly Effect
Cinema Paradiso	Step Up 2: The Streets
The Grudge 2	American Psycho
Field of Dreams	Basic Instinct
The Collection	Snatch
Diamonds Are Forever	Goldfinger
Friday the 13th	Logan
Drag Me to Hell	Captain Phillips
High Fidelity	American Sniper
Blazing Saddles	Red Dragon
The Butterfly Effect	The Butterfly Effect 3: Revelations
Evil Dead II	Tucker and Dale vs Evil
The Woman in Black	Magnolia
The Godfather	Natural Born Killers
Horrible Bosses	Easy A
Saw VI	Noah
Paranormal Activity 4	The Three Musketeers
Quarantine	Scream 2
American Pie	Brick
Marley & Me	The Tree of Life
Police Academy 2: Their First Assignment	Harold & Kumar Escape from Guantanamo Bay
The Lost Boys	The Bourne Legacy
Rounders	Brick
Sideways	Step Up 2: The Streets
Bad Boys II	A History of Violence
The Grudge 3	Saw IV
Bad Lieutenant: Port of Call New Orleans	The Texas Chainsaw Massacre 2
Up	Taken 2
The Grudge	Escape from New York
The Godfather: Part III	The Mechanic
Babel	Jason Goes to Hell: The Final Friday
Whiplash	Wall Street
Rise of the Planet of the Apes	Escape from the Planet of the Apes
BloodRayne	Splice
Halloween	Shutter Island
In the Name of the King: A Dungeon Siege Tale	Tinker Bell and the Lost Treasure
Platoon	Moon
Rain Man	Room
The Final Destination	Final Destination 3
Goodfellas	Independence Day
Edward Scissorhands	Planet Terror
Saw	Scary Movie 2
American Psycho	The Grudge 2
Looper	The Muppets Take Manhattan
Beverly Hills Chihuahua	Scream 3
The Karate Kid	The Aviator
City of God	Johnny English Reborn
Clerks II	Clerks
Glory	Amores Perros
The Elephant Man	Adventureland
Superbad	Exorcist: The Beginning
Final Destination 2	The Conjuring 2
The War of the Roses	Toy Story 2
Carrie	Man of Steel
Redbelt	Changeling
Side Effects	The Hunger Games: Mockingjay - Part 1
Role Models	The Artist
The Muppets	Muppets Most Wanted
Black Hawk Down	Spy Game
Star Trek: The Motion Picture	Star Trek
Escape from L.A.	Four Weddings and a Funeral
Hard Candy	Ratatouille
Face/Off	Snatch
Ratatouille	Hard Candy
Bruno	Star Wars: Episode III - Revenge of the Sith
X2	Madagascar
Terminator 3: Rise of the Machines	Star Trek: First Contact
Straight Outta Compton	Fast Times at Ridgemont High
Damien: Omen II	Hannibal Rising
The Artist	Role Models
Guardians of the Galaxy	The Hills Have Eyes
Step Up 2: The Streets	Miss Congeniality 2: Armed and Fabulous
Fast Times at Ridgemont High	Straight Outta Compton
Spring Breakers	Home Alone 3
Lawrence of Arabia	Poltergeist III
Man of Steel	Carrie
Before Sunrise	Friday the 13th: The Final Chapter
On the Waterfront	The Hangover Part II
Hell or High Water	Friday the 13th: A New Beginning
Edge of Tomorrow	Groundhog Day
RED 2	Once Upon a Time in America
Child's Play 2	Scent of a Woman
The Dark Knight Rises	American Sniper
I Know What You Did Last Summer	The Godfather: Part III
The Fighter	Carrie
Noah	Saw VI
Transformers: Age of Extinction	Harry Potter and the Order of the Phoenix
Kung Fu Panda 2	The Lord of the Rings: The Two Towers
Home Alone 3	Spring Breakers
2 Fast 2 Furious	The Descent: Part 2
The Virgin Suicides	Poltergeist II: The Other Side
The Hobbit: The Battle of the Five Armies	The Hangover Part II
Star Wars: Episode VI - Return of the Jedi	Star Wars: Episode VII - The Force Awakens
Four Weddings and a Funeral	Exorcist: The Beginning
The Princess Diaries 2: Royal Engagement	Happy Feet
Star Trek	Star Trek: First Contact
Galaxy Quest	Star Wars: Episode III - Revenge of the Sith
Godzilla	Finding Nemo
Collateral	Dogville
Death Race	Furious 6
The Lawnmower Man	O Brother, Where Art Thou?
Resident Evil: Degeneration	Logan
Dawn of the Dead	Superman IV: The Quest for Peace
S. Darko	Atlas Shrugged: Part I
Mary Poppins	Psycho
Freeway	Cheaper by the Dozen 2
Spectre	Diamonds Are Forever
Apocalypto	Juno
Police Academy 3: Back in Training	Cast Away
Psycho	Psycho II
Bad Santa	The Wedding Singer
Knocked Up	Jumanji
Rocky IV	Magnolia
The Matrix Revolutions	The Matrix Reloaded
The Social Network	Harold & Kumar Go to White Castle
Dead Poets Society	Boogie Nights
12 Rounds	Miss Congeniality
Spirited Away	The Bourne Ultimatum
Primal Fear	Rush
Hulk	Avengers: Age of Ultron
Gravity	Escape from L.A.
Sex and the City	The Mummy: Tomb of the Dragon Emperor
The Shining	12 Years a Slave
Alvin and the Chipmunks: The Squeakquel	Transformers: Revenge of the Fallen
The Girl with the Dragon Tattoo	The Terminator
Adventureland	Dirty Harry
Superman IV: The Quest for Peace	The Place Beyond the Pines
Harold & Kumar Escape from Guantanamo Bay	Police Academy 2: Their First Assignment
Top Gun	The Hobbit: The Desolation of Smaug
Lost in Translation	Rocky III
Annie Hall	Casablanca
Bonnie and Clyde	I Know What You Did Last Summer
Awakenings	The Expendables
The Green Mile	Changeling
Cloverfield	The Last Exorcism
Poltergeist II: The Other Side	Mean Girls
The Hunger Games: Mockingjay - Part 1	Brokeback Mountain
Annabelle	The Amazing Spider-Man 2
Arrival	The Arrival
Supercop	The Transporter
Tombstone	The Four Musketeers: Milady's Revenge
Unbreakable	Shaun of the Dead
Scream 3	Brazil
Brick	The Grudge 2
Scott Pilgrim vs. the World	Scary Movie
Rush	Unbreakable
Man on the Moon	Point Break
Brazil	Scream 3
Sicario	Ocean's Twelve
Police Story 2	The Hobbit: The Desolation of Smaug
The Maze Runner	Paranormal Activity 2
Hannibal Rising	Insurgent
The Twilight Saga: Breaking Dawn - Part 1	The Collection
Furious 6	Sniper: Reloaded
Ghost Rider	From Dusk Till Dawn
The Great Escape	Children of Men
The Conjuring	The Amazing Spider-Man 2
Midnight Cowboy	Clash of the Titans
Munich	Happy Feet
Life of Brian	The Terminator
Steve Jobs	Dirty Harry
Point Break	Titanic
Layer Cake	WALLÃ‚Â·E
The Lobster	Drive
The Color of Money	Cape Fear
Police Story	Star Trek: The Motion Picture
The Iron Giant	Zoolander
Drive	The Lobster
JFK	I Still Know What You Did Last Summer
Logan	Resident Evil: Degeneration
Friday the 13th Part VIII: Jason Takes Manhattan	The Hills Have Eyes
Pinocchio	Boyz n the Hood
The Spy Who Loved Me	Casino Royale
The Karate Kid Part III	Amores Perros
Star Trek IV: The Voyage Home	The Wedding Singer
The Thomas Crown Affair	Almost Famous
Piranha 3D	Rocky III
Men in Black II	Wrong Turn 4: Bloody Beginnings
End of Watch	Unbreakable
Groundhog Day	Point Break
Captain America: The Winter Soldier	Kick-Ass
The Little Mermaid	Apocalypto
Blade Runner	Bridget Jones: The Edge of Reason
The Passion of the Christ	Hard Candy
Boyz n the Hood	Pinocchio
The Silence of the Lambs	Saving Private Ryan
The Grand Budapest Hotel	Little Miss Sunshine
Leatherface: Texas Chainsaw Massacre III	Magnolia
Spy Game	Blade II
Easy A	Horrible Bosses
Dogville	Alvin and the Chipmunks: The Squeakquel
Taken 2	Taken 3
Manhattan	The Karate Kid Part III
Election	Galaxy Quest
The Da Vinci Code	Hannibal Rising
Underworld: Rise of the Lycans	Underworld: Evolution
The Exorcist	Ghostbusters II
I Still Know What You Did Last Summer	Poltergeist III
Ghostbusters	Sleepy Hollow
Cool Hand Luke	Psycho
The Others	Cheaper by the Dozen
Kick-Ass	Boogeyman
Screamers	Doctor Strange
The Good, the Bad and the Ugly	Friday the 13th Part VII: The New Blood
Changeling	Redbelt
Captain America: Civil War	Poltergeist II: The Other Side
Lone Survivor	O Brother, Where Art Thou?
Eternal Sunshine of the Spotless Mind	Behind Enemy Lines
In Bruges	World War Z
Quantum of Solace	Casino Royale
Avengers: Age of Ultron	Hulk
Batman v Superman	Superman
The Devils Advocate	Lord of War
Star Wars: Episode VII - The Force Awakens	Star Wars: Episode VI - Return of the Jedi
Moon	Platoon
A Clockwork Orange	Damien: Omen II
Mud	The Last Exorcism
Mission: Impossible - Ghost Protocol	Mission: Impossible II
Lara Croft Tomb Raider: The Cradle of Life	Terminator 2: Judgment Day
Rocky Balboa	Beneath the Planet of the Apes
The Insider	Rocky Balboa
The Nice Guys	The Enforcer
Dr. Strangelove or: How I Learned to Stop Worrying and Love the Bomb	Magnolia
